Year,Period,labor_force,employment,unemployment,unemployment_rate
2019,Oct,275928,267540,8388,3.0
2019,Nov,275843,267573,8270,3.0
2019,Dec,273326,265044,8282,3.0
2020,Jan,271386,261336,10050,3.7
2020,Feb,270407,261497,8910,3.3
2020,Mar,268085,256693,11392,4.2
2020,Apr,270381,229273,41108,15.2
2020,May,269081,244721,24360,9.1
2020,Jun,259560,248202,11358,8.7
2020,Jul,248469,237383,11086,5.6
2020,Aug,269465,251841,17624,6.5
2020,Sep,258008,245940,12068,4.7
